,id,framework,complexity,program,ete,fw,diff
0,0,pyglet,rects,getdbits_fw_True,46168,55340,-9172
1,1,pyglet,rects,getdbits_fw_True,36288,30920,5368
2,2,pyglet,rects,getdbits_fw_True,38880,30920,7960
3,3,pyglet,rects,getdbits_fw_True,34064,30920,3144
4,4,pyglet,rects,getdbits_fw_True,39084,14961,24123
5,5,pyglet,rects,getdbits_fw_True,23988,14961,9027
6,6,pyglet,rects,getdbits_fw_True,37996,14961,23035
7,7,pyglet,rects,getdbits_fw_True,38216,14961,23255
8,8,pyglet,rects,getdbits_fw_True,34848,14961,19887
9,9,pyglet,rects,getdbits_fw_True,40772,33864,6908
10,10,pyglet,rects,getdbits_fw_True,48760,42884,5876
11,11,pyglet,rects,getdbits_fw_True,27904,42884,-14980
12,12,pyglet,rects,getdbits_fw_True,41912,42884,-972
13,13,pyglet,rects,getdbits_fw_True,34968,27555,7413
14,14,pyglet,rects,getdbits_fw_True,40684,27555,13129
15,15,pyglet,rects,getdbits_fw_True,24188,27555,-3367
16,16,pyglet,rects,getdbits_fw_True,46260,57356,-11096
17,17,pyglet,rects,getdbits_fw_True,25988,17954,8034
18,18,pyglet,rects,getdbits_fw_True,32476,17954,14522
19,19,pyglet,rects,getdbits_fw_True,26112,17954,8158
20,20,pyglet,rects,getdbits_fw_True,30912,17954,12958
21,21,pyglet,rects,getdbits_fw_True,39428,17954,21474
22,22,pyglet,rects,getdbits_fw_True,36512,30912,5600
23,23,pyglet,rects,getdbits_fw_True,26004,30912,-4908
24,24,pyglet,rects,getdbits_fw_True,33040,27930,5110
25,25,pyglet,rects,getdbits_fw_True,30684,23680,7004
26,26,pyglet,rects,getdbits_fw_True,50984,23680,27304
27,27,pyglet,rects,getdbits_fw_True,34940,23680,11260
28,28,pyglet,rects,getdbits_fw_True,40676,23680,16996
29,29,pyglet,rects,getdbits_fw_True,49320,23680,25640
30,30,pyglet,rects,getdbits_fw_True,46168,23680,22488
31,31,pyglet,rects,getdbits_fw_True,32040,25520,6520
32,32,pyglet,rects,getdbits_fw_True,30020,25520,4500
33,33,pyglet,rects,getdbits_fw_True,36620,25520,11100
34,34,pyglet,rects,getdbits_fw_True,37520,12965,24555
35,35,pyglet,rects,getdbits_fw_True,29460,12965,16495
36,36,pyglet,rects,getdbits_fw_True,29240,12965,16275
37,37,pyglet,rects,getdbits_fw_True,39432,12965,26467
38,38,pyglet,rects,getdbits_fw_True,32372,25405,6967
39,39,pyglet,rects,getdbits_fw_True,43004,38465,4539
40,40,pyglet,rects,getdbits_fw_True,21068,13969,7099
41,41,pyglet,rects,getdbits_fw_True,39652,16995,22657
42,42,pyglet,rects,getdbits_fw_True,60932,16995,43937
43,43,pyglet,rects,getdbits_fw_True,49512,16995,32517
44,44,pyglet,rects,getdbits_fw_True,43800,16995,26805
45,45,pyglet,rects,getdbits_fw_True,38980,31913,7067
46,46,pyglet,rects,getdbits_fw_True,31588,31913,-325
47,47,pyglet,rects,getdbits_fw_True,38980,30952,8028
48,48,pyglet,rects,getdbits_fw_True,39336,30952,8384
49,49,pyglet,rects,getdbits_fw_True,27112,36717,-9605
50,50,pyglet,rects,getdbits_fw_True,28896,36717,-7821
51,51,pyglet,rects,getdbits_fw_True,23744,36717,-12973
52,52,pyglet,rects,getdbits_fw_True,27240,36717,-9477
53,53,pyglet,rects,getdbits_fw_True,53432,36717,16715
54,54,pyglet,rects,getdbits_fw_True,31364,36717,-5353
55,55,pyglet,rects,getdbits_fw_True,35984,36717,-733
56,56,pyglet,rects,getdbits_fw_True,42364,36717,5647
57,57,pyglet,rects,getdbits_fw_True,44132,36717,7415
58,58,pyglet,rects,getdbits_fw_True,34972,36717,-1745
59,59,pyglet,rects,getdbits_fw_True,42368,33883,8485
60,60,pyglet,rects,getdbits_fw_True,52308,59850,-7542
61,61,pyglet,rects,getdbits_fw_True,32368,59850,-27482
62,62,pyglet,rects,getdbits_fw_True,39548,59850,-20302
63,63,pyglet,rects,getdbits_fw_True,35528,26928,8600
64,64,pyglet,rects,getdbits_fw_True,35168,26929,8239
65,65,pyglet,rects,getdbits_fw_True,35520,26929,8591
66,66,pyglet,rects,getdbits_fw_True,37416,31914,5502
67,67,pyglet,rects,getdbits_fw_True,45144,31914,13230
68,68,pyglet,rects,getdbits_fw_True,33384,31914,1470
69,69,pyglet,rects,getdbits_fw_True,46484,31914,14570
70,70,pyglet,rects,getdbits_fw_True,40100,31914,8186
71,71,pyglet,rects,getdbits_fw_True,42248,53368,-11120
72,72,pyglet,rects,getdbits_fw_True,43824,53368,-9544
73,73,pyglet,rects,getdbits_fw_True,34168,53368,-19200
74,74,pyglet,rects,getdbits_fw_True,32260,53368,-21108
75,75,pyglet,rects,getdbits_fw_True,29228,38406,-9178
76,76,pyglet,rects,getdbits_fw_True,34632,38406,-3774
77,77,pyglet,rects,getdbits_fw_True,46404,38406,7998
78,78,pyglet,rects,getdbits_fw_True,50884,38406,12478
79,79,pyglet,rects,getdbits_fw_True,34272,38406,-4134
80,80,pyglet,rects,getdbits_fw_True,26436,38406,-11970
81,81,pyglet,rects,getdbits_fw_True,22172,38406,-16234
82,82,pyglet,rects,getdbits_fw_True,34388,28295,6093
83,83,pyglet,rects,getdbits_fw_True,42360,28295,14065
84,84,pyglet,rects,getdbits_fw_True,43124,28295,14829
85,85,pyglet,rects,getdbits_fw_True,46396,28295,18101
86,86,pyglet,rects,getdbits_fw_True,34856,28441,6415
87,87,pyglet,rects,getdbits_fw_True,31692,28441,3251
88,88,pyglet,rects,getdbits_fw_True,37548,33425,4123
89,89,pyglet,rects,getdbits_fw_True,41440,35906,5534
90,90,pyglet,rects,getdbits_fw_True,50736,60350,-9614
91,91,pyglet,rects,getdbits_fw_True,33736,60350,-26614
92,92,pyglet,rects,getdbits_fw_True,30468,60350,-29882
93,93,pyglet,rects,getdbits_fw_True,30816,60350,-29534
94,94,pyglet,rects,getdbits_fw_True,31588,23901,7687
95,95,pyglet,rects,getdbits_fw_True,39872,23901,15971
96,96,pyglet,rects,getdbits_fw_True,30372,22902,7470
97,97,pyglet,rects,getdbits_fw_True,40572,22902,17670
98,98,pyglet,rects,getdbits_fw_True,55440,46340,9100
99,99,pyglet,rects,getdbits_fw_True,45056,46340,-1284
