,id,framework,complexity,program,ete,fw,diff
0,0,pyglet,default,getdbits_fw_True,30916,0,30916
1,1,pyglet,default,getdbits_fw_True,33604,0,33604
2,2,pyglet,default,getdbits_fw_True,30700,41262,-10562
3,3,pyglet,default,getdbits_fw_True,46620,41262,5358
4,4,pyglet,default,getdbits_fw_True,42892,41262,1630
5,5,pyglet,default,getdbits_fw_True,34624,41262,-6638
6,6,pyglet,default,getdbits_fw_True,38332,41262,-2930
7,7,pyglet,default,getdbits_fw_True,48388,41262,7126
8,8,pyglet,default,getdbits_fw_True,26884,36902,-10018
9,9,pyglet,default,getdbits_fw_True,43804,36902,6902
10,10,pyglet,default,getdbits_fw_True,34408,36902,-2494
11,11,pyglet,default,getdbits_fw_True,23424,36902,-13478
12,12,pyglet,default,getdbits_fw_True,24656,36902,-12246
13,13,pyglet,default,getdbits_fw_True,29700,36902,-7202
14,14,pyglet,default,getdbits_fw_True,33612,36902,-3290
15,15,pyglet,default,getdbits_fw_True,32392,36902,-4510
16,16,pyglet,default,getdbits_fw_True,27444,38896,-11452
17,17,pyglet,default,getdbits_fw_True,42024,38896,3128
18,18,pyglet,default,getdbits_fw_True,31936,38896,-6960
19,19,pyglet,default,getdbits_fw_True,30928,23936,6992
20,20,pyglet,default,getdbits_fw_True,44476,23936,20540
21,21,pyglet,default,getdbits_fw_True,31244,23936,7308
22,22,pyglet,default,getdbits_fw_True,35756,23936,11820
23,23,pyglet,default,getdbits_fw_True,33940,27932,6008
24,24,pyglet,default,getdbits_fw_True,25996,53378,-27382
25,25,pyglet,default,getdbits_fw_True,34176,28923,5253
26,26,pyglet,default,getdbits_fw_True,35760,28923,6837
27,27,pyglet,default,getdbits_fw_True,23076,28923,-5847
28,28,pyglet,default,getdbits_fw_True,39088,28923,10165
29,29,pyglet,default,getdbits_fw_True,44264,28923,15341
30,30,pyglet,default,getdbits_fw_True,48740,42302,6438
31,31,pyglet,default,getdbits_fw_True,41336,42302,-966
32,32,pyglet,default,getdbits_fw_True,37432,42302,-4870
33,33,pyglet,default,getdbits_fw_True,36628,42302,-5674
34,34,pyglet,default,getdbits_fw_True,41020,42302,-1282
35,35,pyglet,default,getdbits_fw_True,35412,42302,-6890
36,36,pyglet,default,getdbits_fw_True,28000,42302,-14302
37,37,pyglet,default,getdbits_fw_True,33716,42886,-9170
38,38,pyglet,default,getdbits_fw_True,45384,42886,2498
39,39,pyglet,default,getdbits_fw_True,39648,42886,-3238
40,40,pyglet,default,getdbits_fw_True,37432,30917,6515
41,41,pyglet,default,getdbits_fw_True,33516,43884,-10368
42,42,pyglet,default,getdbits_fw_True,46260,40891,5369
43,43,pyglet,default,getdbits_fw_True,30604,40891,-10287
44,44,pyglet,default,getdbits_fw_True,30480,40891,-10411
45,45,pyglet,default,getdbits_fw_True,27324,40891,-13567
46,46,pyglet,default,getdbits_fw_True,39120,30912,8208
47,47,pyglet,default,getdbits_fw_True,35956,28922,7034
48,48,pyglet,default,getdbits_fw_True,39788,28922,10866
49,49,pyglet,default,getdbits_fw_True,34948,28922,6026
50,50,pyglet,default,getdbits_fw_True,40220,28922,11298
51,51,pyglet,default,getdbits_fw_True,36848,28918,7930
52,52,pyglet,default,getdbits_fw_True,35172,28918,6254
53,53,pyglet,default,getdbits_fw_True,34184,28918,5266
54,54,pyglet,default,getdbits_fw_True,30352,39612,-9260
55,55,pyglet,default,getdbits_fw_True,51776,39612,12164
56,56,pyglet,default,getdbits_fw_True,41692,39612,2080
57,57,pyglet,default,getdbits_fw_True,40656,51906,-11250
58,58,pyglet,default,getdbits_fw_True,32704,51906,-19202
59,59,pyglet,default,getdbits_fw_True,46708,51906,-5198
60,60,pyglet,default,getdbits_fw_True,31940,51906,-19966
61,61,pyglet,default,getdbits_fw_True,41328,51906,-10578
62,62,pyglet,default,getdbits_fw_True,46952,40889,6063
63,63,pyglet,default,getdbits_fw_True,38308,40889,-2581
64,64,pyglet,default,getdbits_fw_True,48952,40889,8063
65,65,pyglet,default,getdbits_fw_True,31940,40889,-8949
66,66,pyglet,default,getdbits_fw_True,43236,40889,2347
67,67,pyglet,default,getdbits_fw_True,41332,33908,7424
68,68,pyglet,default,getdbits_fw_True,42336,33908,8428
69,69,pyglet,default,getdbits_fw_True,35508,33908,1600
70,70,pyglet,default,getdbits_fw_True,40544,33908,6636
71,71,pyglet,default,getdbits_fw_True,34508,33908,600
72,72,pyglet,default,getdbits_fw_True,39200,33908,5292
73,73,pyglet,default,getdbits_fw_True,44912,33908,11004
74,74,pyglet,default,getdbits_fw_True,32388,24934,7454
75,75,pyglet,default,getdbits_fw_True,44036,24934,19102
76,76,pyglet,default,getdbits_fw_True,41888,24934,16954
77,77,pyglet,default,getdbits_fw_True,37072,12963,24109
78,78,pyglet,default,getdbits_fw_True,25656,35421,-9765
79,79,pyglet,default,getdbits_fw_True,51856,35421,16435
80,80,pyglet,default,getdbits_fw_True,36204,35421,783
81,81,pyglet,default,getdbits_fw_True,45368,35421,9947
82,82,pyglet,default,getdbits_fw_True,48612,42888,5724
83,83,pyglet,default,getdbits_fw_True,44580,37900,6680
84,84,pyglet,default,getdbits_fw_True,43932,35900,8032
85,85,pyglet,default,getdbits_fw_True,39672,35900,3772
86,86,pyglet,default,getdbits_fw_True,35620,35900,-280
87,87,pyglet,default,getdbits_fw_True,35852,35900,-48
88,88,pyglet,default,getdbits_fw_True,41560,35900,5660
89,89,pyglet,default,getdbits_fw_True,44128,35900,8228
90,90,pyglet,default,getdbits_fw_True,36420,35900,520
91,91,pyglet,default,getdbits_fw_True,36512,35900,612
92,92,pyglet,default,getdbits_fw_True,30488,23934,6554
93,93,pyglet,default,getdbits_fw_True,27888,23934,3954
94,94,pyglet,default,getdbits_fw_True,40004,33908,6096
95,95,pyglet,default,getdbits_fw_True,42472,33908,8564
96,96,pyglet,default,getdbits_fw_True,46252,33908,12344
97,97,pyglet,default,getdbits_fw_True,34948,33908,1040
98,98,pyglet,default,getdbits_fw_True,34964,27928,7036
99,99,pyglet,default,getdbits_fw_True,35752,27928,7824
