,id,framework,complexity,program,ete,fw,diff
0,0,javaswing,rects,bitblt_fw_True,84612,0,84612
1,1,javaswing,rects,bitblt_fw_True,88416,0,88416
2,2,javaswing,rects,bitblt_fw_True,97888,0,97888
3,3,javaswing,rects,bitblt_fw_True,89824,0,89824
4,4,javaswing,rects,bitblt_fw_True,97452,0,97452
5,5,javaswing,rects,bitblt_fw_True,87748,0,87748
6,6,javaswing,rects,bitblt_fw_True,345648,0,345648
7,7,javaswing,rects,bitblt_fw_True,218844,0,218844
8,8,javaswing,rects,bitblt_fw_True,74532,0,74532
9,9,javaswing,rects,bitblt_fw_True,92672,0,92672
10,10,javaswing,rects,bitblt_fw_True,81236,0,81236
11,11,javaswing,rects,bitblt_fw_True,94252,78322,15930
12,12,javaswing,rects,bitblt_fw_True,95228,78322,16906
13,13,javaswing,rects,bitblt_fw_True,83000,78322,4678
14,14,javaswing,rects,bitblt_fw_True,282752,78322,204430
15,15,javaswing,rects,bitblt_fw_True,85628,78322,7306
16,16,javaswing,rects,bitblt_fw_True,208348,188524,19824
17,17,javaswing,rects,bitblt_fw_True,73972,188524,-114552
18,18,javaswing,rects,bitblt_fw_True,67104,188524,-121420
19,19,javaswing,rects,bitblt_fw_True,88028,188524,-100496
20,20,javaswing,rects,bitblt_fw_True,121516,188524,-67008
21,21,javaswing,rects,bitblt_fw_True,76540,55393,21147
22,22,javaswing,rects,bitblt_fw_True,87696,83054,4642
23,23,javaswing,rects,bitblt_fw_True,67552,66614,938
24,24,javaswing,rects,bitblt_fw_True,87296,66614,20682
25,25,javaswing,rects,bitblt_fw_True,216152,66614,149538
26,26,javaswing,rects,bitblt_fw_True,84560,66614,17946
27,27,javaswing,rects,bitblt_fw_True,89644,66614,23030
28,28,javaswing,rects,bitblt_fw_True,75948,66614,9334
29,29,javaswing,rects,bitblt_fw_True,274496,253356,21140
30,30,javaswing,rects,bitblt_fw_True,83112,253356,-170244
31,31,javaswing,rects,bitblt_fw_True,96728,253356,-156628
32,32,javaswing,rects,bitblt_fw_True,76720,253356,-176636
33,33,javaswing,rects,bitblt_fw_True,60052,69333,-9281
34,34,javaswing,rects,bitblt_fw_True,259488,69333,190155
35,35,javaswing,rects,bitblt_fw_True,75604,69333,6271
36,36,javaswing,rects,bitblt_fw_True,281116,69333,211783
37,37,javaswing,rects,bitblt_fw_True,82808,69333,13475
38,38,javaswing,rects,bitblt_fw_True,77424,69333,8091
39,39,javaswing,rects,bitblt_fw_True,77900,69333,8567
40,40,javaswing,rects,bitblt_fw_True,76728,69333,7395
41,41,javaswing,rects,bitblt_fw_True,88172,69333,18839
42,42,javaswing,rects,bitblt_fw_True,88152,69333,18819
43,43,javaswing,rects,bitblt_fw_True,219404,69333,150071
44,44,javaswing,rects,bitblt_fw_True,85284,69333,15951
45,45,javaswing,rects,bitblt_fw_True,77332,69333,7999
46,46,javaswing,rects,bitblt_fw_True,82140,69333,12807
47,47,javaswing,rects,bitblt_fw_True,58396,69333,-10937
48,48,javaswing,rects,bitblt_fw_True,87804,69333,18471
49,49,javaswing,rects,bitblt_fw_True,93680,69333,24347
50,50,javaswing,rects,bitblt_fw_True,137504,69333,68171
51,51,javaswing,rects,bitblt_fw_True,83164,69333,13831
52,52,javaswing,rects,bitblt_fw_True,225288,69333,155955
53,53,javaswing,rects,bitblt_fw_True,84472,69333,15139
54,54,javaswing,rects,bitblt_fw_True,92184,69333,22851
55,55,javaswing,rects,bitblt_fw_True,68992,69333,-341
56,56,javaswing,rects,bitblt_fw_True,75868,69333,6535
57,57,javaswing,rects,bitblt_fw_True,84912,69333,15579
58,58,javaswing,rects,bitblt_fw_True,92516,73368,19148
59,59,javaswing,rects,bitblt_fw_True,90168,73368,16800
60,60,javaswing,rects,bitblt_fw_True,109820,73368,36452
61,61,javaswing,rects,bitblt_fw_True,251812,73368,178444
62,62,javaswing,rects,bitblt_fw_True,84896,73368,11528
63,63,javaswing,rects,bitblt_fw_True,81884,73368,8516
64,64,javaswing,rects,bitblt_fw_True,80468,73368,7100
65,65,javaswing,rects,bitblt_fw_True,105076,73368,31708
66,66,javaswing,rects,bitblt_fw_True,87600,68336,19264
67,67,javaswing,rects,bitblt_fw_True,293668,255853,37815
68,68,javaswing,rects,bitblt_fw_True,54464,255853,-201389
69,69,javaswing,rects,bitblt_fw_True,91228,255853,-164625
70,70,javaswing,rects,bitblt_fw_True,93924,255853,-161929
71,71,javaswing,rects,bitblt_fw_True,82676,255853,-173177
72,72,javaswing,rects,bitblt_fw_True,84032,255853,-171821
73,73,javaswing,rects,bitblt_fw_True,77112,60838,16274
74,74,javaswing,rects,bitblt_fw_True,275964,60838,215126
75,75,javaswing,rects,bitblt_fw_True,91784,60838,30946
76,76,javaswing,rects,bitblt_fw_True,110096,60838,49258
77,77,javaswing,rects,bitblt_fw_True,90048,60838,29210
78,78,javaswing,rects,bitblt_fw_True,87712,81341,6371
79,79,javaswing,rects,bitblt_fw_True,55568,81341,-25773
80,80,javaswing,rects,bitblt_fw_True,74032,81341,-7309
81,81,javaswing,rects,bitblt_fw_True,75524,81341,-5817
82,82,javaswing,rects,bitblt_fw_True,78668,69331,9337
83,83,javaswing,rects,bitblt_fw_True,85468,69331,16137
84,84,javaswing,rects,bitblt_fw_True,83440,69331,14109
85,85,javaswing,rects,bitblt_fw_True,63508,69331,-5823
86,86,javaswing,rects,bitblt_fw_True,106404,69331,37073
87,87,javaswing,rects,bitblt_fw_True,97548,69331,28217
88,88,javaswing,rects,bitblt_fw_True,160468,69331,91137
89,89,javaswing,rects,bitblt_fw_True,205320,69331,135989
90,90,javaswing,rects,bitblt_fw_True,91640,69331,22309
91,91,javaswing,rects,bitblt_fw_True,65344,69331,-3987
92,92,javaswing,rects,bitblt_fw_True,57464,69331,-11867
93,93,javaswing,rects,bitblt_fw_True,50768,67360,-16592
94,94,javaswing,rects,bitblt_fw_True,91392,67360,24032
95,95,javaswing,rects,bitblt_fw_True,80216,67360,12856
96,96,javaswing,rects,bitblt_fw_True,103780,85304,18476
97,97,javaswing,rects,bitblt_fw_True,93972,85304,8668
98,98,javaswing,rects,bitblt_fw_True,212912,85304,127608
99,99,javaswing,rects,bitblt_fw_True,274852,85304,189548
